
SO textures/south.xpm
NO textures/north.xpm
WE textures/west.xpm
EA textures/east.xpm


  F 220,100,1
                1111111111111111111111111
                1000000000110000000000001
                1011000001110000000000001
                1001000000000000000000001
        111111111011000001110000000000001
        100000000011000001110111111111111
        111101111111110111000000100011
        111110111111111011101010011101
        11000000110101011100000010001
        100000000000000011000000100011
        100000000000000011010100100101
        11000001110101011101011010N111
        11110111 1110101 101111010001
        11111111 1111111 111111111111


 C 225,30,0      
