NO textures/wall_1.xpm
SO textures/wall_2.xpm
WE textures/wall_3.xpm
EA textures/wall_4.xpm

F 220,100,0

C 0,0,0

        1111111111111111111111111
        100000000110000001000001
        1011000001110000000100001
       111001000000000000001000001
111111110110000011100000000000001
100000000011000001110111111111111
11110111111111011100000010001
11110111111111011101010010001 
110011001101010111000000100011                 1111
1001 1000000000000110000001000111              1001
100111000000000011010100100001                 1111
11000001110101011111011110S0111
11110111  1110101 101111010001 
11111111 1111111 111111111111               







